000000000000
03    30  30
0   2  0   0
0  0 0 0 0 0
03 2 2 0 0 0
0  030 0 2 0
03 2 2 0   0
00 0 03012 0
0 2 2  0 0 0
0       2  0
0 3  3  0 30
000000000000
