000000000000
03        10
0  0 0 0 0 0
0  00000 0 0
0    0   2 0
0    0   2 0
0  00000 0 0
0  0 0 0 0 0
0          0
0          0
030 0 0 0 00
000000000000
