000000000000
03   0   010
0   30 0 2 0
03   0 2 0 0
000 00 0 2 0
03   0 2 0 0
000  3 0 2 0
03   0 2 0 0
0 0  0 0 2 0
0       2  0
030  0 0 030
000000000000
